....................................................................
   **************   *  *** **  *      ******************************
  ********************* ** ** *  * ****************************** *
 **      *****************       ******************************
 	  *************          **  * **** ** ************** *
	   *********            *******   **************** * *
 	    ********	       ***************************  *
   *	    * **** ***	       *************** ******  ** *
 	       ****  *	       ***************   *** ***  *
 		 ****** 	*************    **   **  *
 		 ******** 	 *************    *  ** ***
		   ********	    ******** 	      * *** ****
		   *********	     ******  *	      **** ** * **
 		   ********* 	     ****** * * 	  *** *   *
		     ****** 	     ***** **		  *****   *
 		     ***** 	      **** * 		********
		    ***** 	      **** 		*********
		    **** 	      ** 		 *******   *
	       	    *** 				      *    *
 		    **     * 			*
...................................................................."""
